71,67,67,67,67,67,67,67,67,67,67,67,67,67,67,67,67,67,67,71
69,54,54,53,53,53,53,53,53,53,53,53,53,53,53,53,55,55,55,63
69,54,53,53,53,53,53,53,53,53,53,53,53,53,53,53,53,55,55,63
69,53,53,53,53,53,53,53,53,53,53,53,53,53,53,53,53,53,55,63
69,53,53,54,55,53,53,54,55,53,53,53,53,53,53,53,53,53,53,63
65,53,53,53,53,55,54,53,53,53,53,53,53,53,53,53,53,53,53,63
41,53,53,53,53,54,55,53,53,53,53,54,55,53,53,53,53,53,53,63
32,41,53,53,53,58,64,53,53,53,54,53,53,55,53,53,53,53,53,63
32,32,41,53,53,53,53,54,55,53,58,66,66,64,53,54,55,53,53,63
70,66,64,28,53,53,53,58,70,64,53,53,53,53,58,66,64,53,53,63
69,53,54,28,53,53,54,53,61,53,55,53,53,53,55,53,54,53,53,59
69,54,53,28,53,54,53,54,61,55,53,55,53,53,53,53,53,53,53,43
69,53,54,28,53,53,54,53,61,53,55,53,53,53,53,53,53,53,43,36
69,54,53,28,53,53,53,54,61,55,53,53,53,53,53,53,53,43,36,36
71,70,70,70,70,70,70,70,71,70,70,70,70,70,70,70,70,70,70,70